################
#...,f#......,f#
#.____#......__#
#+.....--......#
#..........#.-.#
#.+.......##.,.#
#.....--.###-..#
#.-......###..f#
#.,..+..##.1####
#..+....##._#D##
#@...1.U.....,F#
################
Доберитесь до выхода!