################
#f.,.........,f#
#_____.......__#
#......--......#
#.,........#...#
#.........##+..#
#.....--.###.+.#
#.,......###..f#
#....+.,########
#..+....#.#.#.##
#@...2...U.U.UF#
################
Доберитесь до выхода!