#______________#
#.............F#
#f#.#..#......##
#__...____..#._#
#...........#.f#
#f##__._....___#
#_#............#
#.#####.._____.#
#.....#........#
#___.._______._#
#@.............#
################