################
#f.,..+...,.+.F#
####.#..++...__#
#....###########
#...+.....#...f#
#__..#........_#
#....######....#
#...+..#.f#_.-.#
#__..#.#._#..,.#
#,...#._+.#.___#
#@..+#+..+#..,F#
################
В этой части пещеры очень темно, двигайтесь на ощупь!