############.###
#f..........U.f#
#__.###########
#++.......#..DF#
#...#####.#._._#
#..+#1.f#.#+..@#
#...#_.#.+#__._#
#+..#.-##.#+.+.#
#...#.....#....#
#..+#######..-.#
#+.............#
################
В этой части пещеры очень темно, двигайтесь на ощупь!