################
#..............#
#..............#
#..............#
#..............#
#..............#
#..............#
#..............#
#......#....#D.#
#.......U......#
#@..1...D..1..F#
########.####U##
Доберитесь до выхода!