################
#F.............#
#############..#
#..,.......,._.#
#.....f........#
#..#############
#._............#
#.....f........#
#############..#
#..,.......,._.#
#@....f........#
################
Добро пожаловать в обучение