#______________#
#..,........,.F#
#f#.#..#......##
#__...____..#._#
#...........#.f#
#f##__._....___#
#_#............#
#.#####.._____.#
#..,..#........#
#___.._______._#
#@........,....#
################
В этой части пещеры очень темно, двигайтесь на ощупь!