################
#.f#..........1#
#+_#..+......+_#
#..#...........#
#...-.........-#
####..-...-.#-.#
#f.#...-....#.-#
#_.#........#-.#
#.########..#.f#
#+..........####
#@........+.DDF#
############..##
Доберитесь до выхода!