################
#1............f#
#________....._#
#f........-.-..#
#########......#
#f......#..-...#
#_......_......#
#..-..........+#
#....-..########
#..-....#.#.#.##
#@.......U.U.UF#
################
Доберитесь до выхода!