################
##.,.#....D..,f#
#1.#.......#####
#_______.......#
#f.......+.....#
#____......##..#
#f,.........._.#
#__...+.......+#
#.......########
#...+..,#.#.#.##
#@.......U.U.UF#
################
Доберитесь до выхода!