################
#..............#
#..............#
#..............#
#..............#
#..............#
#....--........#
#..............#
#..........#...#
#...........#..#
#@.......2..D.F#
############.###
В этой части пещеры очень темно, двигайтесь на ощупь!